Titulo=Estadística de Facturación
LOAD=SinEtiqueta
CargarConfiguraciones=SinEtiqueta
BtnEsVisible=SinEtiqueta
lblFechaInicial=Del*:
lblFechaFinal=Al*:
lblFechas=Rango de Fechas:
lblFamilia=Familia*:
lblProducto=Producto*:
lblCliente=Cliente*:
lblGpoCosteo=Gpo. Costeo*:
lblAlambron=Alambron*:
lblAgrTipoProducto=Agr. Tipo Producto:
lblTipoMercado=Tipo Mercado*:
lblMarca=Marca*:
EstFacturacion-ClaArticulo=ClaArticulo
EstFacturacion-FechaViaje=Fecha Viaje
EstFacturacion-ClaveArticulo=Clave
EstFacturacion-NomArticulo=Producto
EstFacturacion-ClaPedido=Pedido
EstFacturacion-NombreCliente=Cliente
EstFacturacion-FechaPromesaOrigen=Fecha Promesa
EstFacturacion-KilosSurtidos=Kgs. Surtido
EstFacturacion-UnidadesSurtidas=Unidades Surtidas
EstFacturacion-ImporteFlete=Inporte Flete X Producto
EstFacturacion-ClaMoneda=Clave Moneda
EstFacturacion-NombreCortoMoneda=Moneda
EstFacturacion-IdPlanCarga=Número Plan
EstFacturacion-IdViaje=Viaje
EstFacturacion-IdNumTabular=Tabular
EstFacturacion-IdFactura=Factura
EstFacturacion-ClaConsignado=Clave Consignado
EstFacturacion-NombreConsignado=Nombre Consignado
EstFacturacion-IdOpm=OPM
EstFacturacion-NomTipoMercado=Tipo Mercado
EstFacturacion-NomTransportista=Transportista
EstFacturacion-PesoTeoricoKgs=Peso Teórico Kgs
EstFacturacion-ShipID=Ship ID
